5
 ######
##.Aa@#
#B.Cc#
#bD.@#
#@d@.#
######
